#####################################################  
||.................................................|| 
||.. %%%%%%%%%%%%%%%%        ...     %%%%%%%%%%%%%%|| 
||..        |%|   |%|     |%|...     |%|        |%||| 
||..        |%|   |%|     |%|...     |%|        |%||| 
||..                  . . |%|...     %%%%%     %%%%|| 
||..        |%|       . . |%|...    ...............|| 
||..                    . |%|...                   || 
||..                                |%|            || 
||..                                |%|      |%|   || 
||..     |%|%%%|%|.|%|. |%|       G          |%|   || 
||..|%|  |%|   |%|..    %%%%%%%%%%%%%        |%|   || 
||..|%|  |%|   |%|..           ...|%|     %%%%%%   || 
||..               .           ...|%|              || 
||..|%|                        ...|%|              || 
||                                                 || 
||   ............................................  || 
||..|%|  |%|   |%|..    %%%%%%%%%%%%%  ......|%|   || 
||..|%|  |%|   |%|..           ...|%|     %%%%%%   || 
||..|%|            .           ...|%|              || 
||..|%|                        ...|%|%%%%%%%%%%    || 
||                                                 || 
||  .............................................  || 
||..|%|  |%|   |%|..    %%%%%%%%%%%%%        |%|   || 
||                                                 || 
||       ............                              || 
||..                  . . |%|...     %%%%%     %%%%|| 
||                         |%|      |%|            || 
||          ...             |%|         .....      || 
||                           |%|                   || 
##################################################### 
