################################################
||                                            ||
||   ########                ##########       ||
||   ########                  ##########     ||
||   ########                    ##########   ||
||                                            ||
||                                            ||
||                                            ||
||                   ####            ####     ||
||                     ||             ####    ||
||                   ####                     ||
||####                                        ||
|| ####                                       ||
||                                            ||
||                                            ||
||                    ###                     ||
||                     ||           ####      ||
||                    ###           ####      ||
||                                  ####      ||
||                                            ||
||                                            ||
||            ####                            ||
||            ####                            ||
||            ####                            ||
||                                            ||
||                                            ||
||                                            ||
################################################