################################################
||                                            ||
||     #########          ##############      ||
||          |#|   |#|     |#|        |#|      ||
||          |#|   |#|     |#|        |#|      ||
||                        |#|        ###      ||
||          |#|           |#|                 ||
||                        |#|                 ||
||                                            ||
||                                      |%|   ||
||                                      |%|   ||
||                      #############   |%|   ||
||       |#|   |#|                |#|         ||
||                                |#|         ||
||                                |#|         ||
||                      #############         ||
||                                            ||
||                                            ||
||                                            ||
||   |#|  |#|   |#|      #############        ||
||                                            ||
||                                            ||
||                        |#|         #####   ||
||                         |#|      |%|       ||
||                          |#|               ||
||                           |#|              ||
||                                            ||
################################################
